data
s Dough
s Cheese
end
map
##vv####vv##
#----------c
#---####---c
#----##----#
#--######--#
#----##----#
#---####---d
#----------#
####ssss####
end
