data
s=Dough
s=Cheese
s=Meat
s=Tomato
map
##v##vv##v##
#----------c
#----------c
#----------#
#----------#
##t######t##
#----------#
#----------#
#----------d
#----------#
####ssss####
end
