data
s=D
s=C
s=M
s=T
end
map
##v##vv##v##
#----------c
#----------c
#----------#
#----------#
##t######t##
#----------#
#----------#
#----------d
#----------#
####ssss####
end
