data

map
##-##--##-##
#          c
#          c
#          #
#          #
##t##  ##t##
#          #
#          #
#          d
#          #
####ssss####
end
